# http://www.wikihow.com/Say-Hello-in-Different-Languages
Afrikaans : hallo
Alibamu : chíkmàa
Amharic : tena yistelegn, Selam
Albanian : tungjatjeta, c'kemi
A'Leamona : tel nĩdo, tehl-neye-doe
Arabic :  صباح الخير,  مساء الخير 
Armenian : barev, parev
Austrian : grüßgott, servus
Azerbaijani : salam
Basque : kaixo, egun on, gau on
Belarusian : pryvitańnie
Bengali : namaskar
Bodo : wai, oi oye
Bremnian : koali
Breton : degemer mad
Bulgarian : zdravei, zdraveite, zdrasti, dobro utro, dobar den, dobar vecher
Bosnian : hej, dobar dan, cao, laku noc
Burmese : mingalarba
Cambodian : sua s'dei, jum reap sour, arun sua s'dei, tivea sua s'dei, sayoan sua s'dei, reatrey sua s'dei, lea hoy, jum reap lea
Cape-Verdean Creole : oi, olá, entao, don dia
Catalan : hola, bon dia, bona tarda, bona nit
Cayuga (Northern Iroquois) : sga-noh
Chamorro : hafa adai, hafa, howzzit, sup
Chichewa : moni bambo, moni mayi, muribwanji
Chubby : shabe yabebabe yeshe
Chinese : 你好, 早上好, 早
Congolese : mambo
Cook Islands Maori : kia orana
Cree : tansi
Croatian : bok, dobro jutro, dobar dan, dobra večer, laku noć
Czech : dobré ráno, dobrý den, dobrý večer, ahoj
Danish : hej, goddag, godaften, hey, hejsa, halløj
Dioula (Ivory Coast, Burkina Faso) : in-i-che
D'ni : shorah
Double Dutch : hutch-e-lul-lul-o, gug-o-o-dud mum-o-rug-nun-i-nun-gug, gug-o-o-dud a-fuf-tut-e-rug-nun-o-o-nun, gug-o-o-dud e-vuv-e-nun-i-nun-gug
Dutch : hoi, hallo, goedendag
Dzongkha : kuzu-zangpo
Edo (Nigeria) : kóyo
English - American : hello, hi, hey, yo
English - England : how do you do, good morning, good afternoon, good evening, hello, howdo, watchya, alright, hi, hiyal
English - Ireland : hello, hi, hey, yo, hiya
English - Scotland : hello, hi, hey, yo, hiya, howzitgaun
Esperanto : saluton, sal
Estonian : tere päevast, tere hommikust, tere Õhtust
Egyptian Arabic : salaam alekum, ma salaama
Fijian : bula uro, bula vinaka
Finnish : hyvää päivää, moi, terve, hei, moro
French : salut, allo, bonjour, bonsoir, bonne nuit
Frisian : goeie dei, goeie
Gaelic : dia duit
Georgian : gamardjoba
German - Traditional : hallo, guten tag, tag
German - Austrian and Bavarian : grüß gott, servus
German - Northern : moin, moin moin, moinsen
German - Swiss : hallo, grüezi, grüessech
Gibberish : huthegelluthego, h-idiguh-el l-idiguh-o, h-diguh-i, h-idiguh-ow a-diguh-re y-idigah-ou
Greek : Γεια σου, Γεια σας, καλημέρα, καλό απόγευμα, καλησπέρα
Gujarati : namaste, namaskar, kemcho
Haida (Queen Elizabeth Island Canada) : kii-te-daas a
Hausa : ina kwaana, ina uni, ina kwaanan ku, ina unin Ku
Hawaiian : aloha
Hebrew : shalom, hi, ma korae
Hindi : नमस्ते, namaste
Hopi : ha'u, um waynuma
Hungarian, Magyar : jó napot, szervusz, szia, heló
Icelandic : góðan dag, hæ
Igbo : nde-ewo, nna-ewo, ke-du
Indonesian : halo, selamat pagi, selamat siang, selamat malam
Irish : dia duit
Islamic Greeting : السّلام عليكم
Italian : ciào, buon giorno, buon pomeriggio, buona sera
Japanese : おはよう, ございます, こんにちは, こんばんは, もし　もし, どうも
Jamaican Patois : yow wah gwaan
Kanien'kéha (Mohawk) : kwe kwe
Kannada : namaskara
Kazakh : salem, kalay zhagday
Klingon : nuqneh
Konkani : namaskar, namaskaru, dev baro dis div
Korean : 안녕하세요, 안녕, 여보세요
Kurdish : choni, roj bahsh
Lao : sabaidee
Latin (Classical) : salve, salvete, ave, avete
Latvian : labdien, sveiki, chau
Lingala : mbote
Lithuanian : laba diena, labas, sveikas, sveika, sveiki
Lojban : coi
Luxembourgish : moïen
Slavomacedonian : Здраво, Добро утро, Добар ден, Добро вечер
Malayalam : namaskkaram
Malaysian : selamat datang, apa khabar
Maldivian (Dhivehi) : kihineth
Maltese : merħba, bonġu, bonswa, il-lejl it-tajjeb
Maori : kia ora, kia o ra, tena koe, ata marie, morena
Marathi : namaskar
Marshallese : iakwe
Mongolian : sain baina uu, sain uu, ugluunii mend, udriin mend, oroin mend
Nahuatl : niltze, hao
Naokien : atetgrealot, atetel
Navajo : ya'at'eeh
Na'vi : kaltxì, oel ngati kameie
Niuean : faka lofa lahi atu, fakalofa
Neapolitan : cia, cha
Nepalbhasha : Jwajalapa, ज्वजलपा
Nepali : namaskar, namaste, k cha, kasto cha
Northern Sami : buorre beaivi, bures
Northern Sotho : dumelang
Norwegian : hei, hallo, heisann, god morgen, god dag, god kveld
Oshikwanyama : wa uhala po, meme, wa uhala po, tate, nawa tuu, ongaipi
Oromo (Afan Oromo) : asham, akkam, nagaa
Palauan : alii
Pirate : arrrguh, ahoy matey
Persian : salaam, do-rood, as-salaam-o-aleykum
Pig Latin : eyhay, ellohay, atswhay upay
Polish : dzień dobry, witaj, cześć
Portuguese : oi, boas, olá, alô, bom dia, bons dias, boa tarde, boas tardes, boa noite, boas noites
Punjabi : sat sri akal
Rajasthani (Marwari) : khamma ghani sa, ram ram sa
Romanian : salut, buna dimineata, buna ziua, buna seara, buna
Russian : Privet, zdravstvuyte
Samoan : talofa, malo
Scanian : haja, hallå, go'da, go'maren, go'aften
Senegal : salamaleikum
Serbian : zdravo, ćao, dobro jutro, dobar dan, dobro veče, laku noć, do viđenja
Sinhala : a`yubowan, kohomada
Slovak : dobrý deň, ahoj, čau, dobrý
Slovenian : živjo, zdravo, dobro jutro, dober dan, dober večer
South African English : hoezit
Southern Sami : buaregh
Spanish : hola, alo, qué onda, qué hay, qué pasa, buenos días, buenas tardes, buenas noches, qué transa, qué tál
Sulka : marot, mavlemas, masegin
Swahili : jambo, hujambo, habari gani
Swedish : tja, hej, god dag
Tagalog (Pilipino - Philippines) : kumusta po kayo, kumusta ka, kumusta na po kayo, kumusta ka na, magandang umaga po, magandang hapon po, magandang gabi po, magandang tanghali po
Tahitian : ia orana
Taiwanese (Hokkien) : li-ho
Tamil : vanakkam
Telugu : namaskaram, baagunnara
Tetum (Timor-Leste) : bondia, botarde, bonite
Thai : sawa dee-ka, sawa dee-krap
Tibetan - Lhasa Dialect : tashi delek
Tibetan - Amdo Dialect : cho demo
Tigrinya (Ethiopia and Eritrea) : selam, haderkum, t'ena yehabeley
Tongan : malo e lelei
Tshiluba : moyo
Tsonga (South Africa) : minjhani, kunjhani
Turkish : merhaba, selam
Ukrainian : dobriy ranok, dobriy den, dobriy vechir, pryvit
Uzbek : assalomu alaykum, salom
Ung Tongue : hello
Urdu : adaab, salam, as salam alei kum
Vietnamese : xin chào
Welsh : shwmae, sut mae, or s'mae, helo
Yiddish : sholem aleikhem, borokhim aboyem or gut morgn, gutn ovnt, gutn tog, gut shabbos
Yoruba : r kaaro, r kaasan, r kaaale, o da aaro
Zulu : sawubona, sanibonani
